100
100
PPPPPPPPPPPPPPPPPPPPPPPPPPPPPPPPPPPPPPPPPPPPPPPPPPPPPPPPPPPPPPPPPPPPPPPPPPPPPPPPPPPPPPPPPPPPPPPPPPPP
PPPPPPPPPPPPPPPPPPPPPPPPPPPPPPPPPPPPPPPPPPPPPPPPPPPPPPPPPPPPPPPPPPPPPPPPPPPPPPPPPPPPPPPPPPPPPPPPPPPP
PPPPPPPPPPPPPPPPPPPPPPPPPPPPPPPPPPPPPPPPPPPPPPPPPPPPPPPPPPPPPPPPPPPPPPPPPPPPPPPPPPPPPPPPPPPPPPPPPPPP
PPPTTTTTTTTTTTTTTTTTTTTTTTTTTTTTTTTTTTTTTTTTTTTTTTTTTTTTTTTTTTTTTTTTTTTTTTTTTTTTTTTTTTTTTTTTTTTTTPPP
PPPTTTTTTTTTTTTTTTTTTTTTTTTTTTTTTTTTTTTTTTTTTTTTTTTTTTTTTTTTTTTTTTTTTTTTTTTTTTTTTTTTTTTTTTTTTTTTTPPP
PPPTTTTTTTTTMMMMMMMMMMTTTTTTTTTTTTTTTTTTTTTMMMMMMMMMMTTTTTTTTMMMMMMMMMMMMMMMMMMMMMMMTTTTTTTTTTTTTPPP
PPPTTTTTTTTTMTTTTTTTTMTTTTTTTTTTTTTTTTTTTTTMTTTTTTTTMTTTTTTTTMTTTTTTTTTTTTTTTTTTTTTTTTTTTTTTTTTTTPPP
PPPTTTTTTTTTMTTTTTTTTMTTTTTTTTTTTTTTTTTTTTTMTTTTTTTTMTTTTTTTTMMDMMMMMMMMMMMMMMMMMMMMTTTTTTTTTTTTTPPP
PPPTTTTTTTTTMTTTTTTTTMMMTTTTTTTTTTTTTTTTTTTMTTTTTTTTMTTTTTTTTMTTTTTTTTTTTTTTTTTTTTTMTTTTTTTTTTTTTPPP
PPPTTTTTTTKTMTTTTTTTTTTMMTTTTTTTTTTTTTTTTTTMTTTTTTTTMTTTTTTTTMTTTTTTTTTTTTTTTTTTTTTMTTTTTTTTTTTTTPPP
PPPTTTTTTTTTMTTTTTTTTTTTMMTTTTTTTTTTTTTTTTTMTTTTTTTTMTTTTTTTTMTTTTTTTTTTTTTTTTTTTTTMTTTTTTTTTTTTTPPP
PPPTTTTTTTTTMTTTTTTTTTTTTMTTTTTTTTTTTTTTTTTDTTTTTTTTDTTTTTTTTMTTTTTTTTTTTTTTTTTTTTTMTTTTTTTTTTTTTPPP
PPPTTTTTTTTTDTTTTTTTTTTTTMTTTTTTTTTTTTTTTTTMTTTTTTTTMTTTTTTTTMTTTTTTTTTTTTTTTTTTTTTMTTTTTTTTTTTTTPPP
PPPTTTTTTTTTMTTTTTTTTTTTTMTTTTTTTTTTTTTTTTTMTTTTTTTTMTTTTTTTTMTTTTTTTTTTTTTTTTTTTTTMTTTTTTTTTTTTTPPP
PPPTTTTTTTTTMTTTTTTTTTTTTMTTTTTTTTTTTTTTTTTMTTTTTTTTMTTTTTTTTMMMMMMMMMMMMMMMMMMMMMDMTTTTTTTTTTTTTPPP
PPPTTTTTTTTTMTTTTTTTTTTTTMTTTTTTTTTTTTTTTTTMTTTTTTTTMTTTTTTTTTTTTTTTTTTTTTTTTTTTTTTMTTTTTTTTTTTTTPPP
PPPTTTTTTTTTMMMMMMMMMMMMMMTTTTTTTTTTTTTTTTTMMMMMMMMMMTTTTTTTTMMMMMMMMMMMMMMMMMMMMMMMTTTTTTTTTTTTTPPP
PPPTTTTTTTTTTTTTTTTTTTTTTTTTTTTTTTTTTTTTTTTTTTTTTTTTTTTTTTTTTTTTTTTTTTTTTTTTTTTTTTTTTTTTTTTTTTTTTPPP
PPPTTTTTTTTTTTTTTTTTTTTTTTTTTTTTTTTTTTTTTTTTTTTTTTTTTTTTTTTTTTTTTTTTTTTTTTTTTTTTTTTTTTTTTTTTTTTTTPPP
PPPPPPPPPPPTTTPPPPPPPPPPPPPPPPPPPPPPPPPPPPPPPPPPPPPPPPPPPPPPPPPPPPPPPPPPPPPPPPPPPPPPPPPPPPPPPPPPPPPP
PPPTTTTTTTTTTTTTTTTTTTTTTTTTTTTTTTTTTTTTTTTTTTTTTTTTTTTTTTTTTTTTTTTTTTTTTTTTTTTTTTTTTTTTTTTTTTTTTPPP
PPPTTTTTTTTTTTTTTTTTTTTTTTTTTTTTTTTTTTTTTTTTTTTTTTTTTTTTTTTTTTTTTTTTTTTTTTTTTTTTTTTTTTTTTTTTTTTTTPPP
PPPTTTTTTTTTMMMMMMMMMMTTTTTTTTTTTTTTTTTTTTTMMMMMMMMMMTTTTTTTTMMMMMMMMMMMMMMMMMMMMMMMTTTTTTTTTTTTTPPP
PPPTTTTTTTTTMTTTTTTTTMTTTTTTTTTTTTTTTTTTTTTMTTTTTTTTMTTTTTTTTMTTTTTTTTTTTTTTTTTTTTTTTTTTTTTTTTTTTPPP
PPPTTTTTTTTTMTTTTTTTTMTTTTTTTTTTTTTTTTTTTTTMTTTTTTTTMTTTTTTTTMMDMMMMMMMMMMMMMMMMMMMMTTTTTTTTTTTTTPPP
PPPTTTTTTTTTMTTTTTTTTMMMTTTTTTTTTTTTTTTTTTTMTTTTTTTTMTTTTTTTTMTTTTTTTTTTTTTTTTTTTTTMTTTTTTTTTTTTTPPP
PPPTTTTTTTKTMTTTTTTTTTTMMTTTTTTTTTTTTTTTTTTMTTTTTTTTMTTTTTTTTMTTTTTTTTTTTTTTTTTTTTTMTTTTTTTTTTTTTPPP
PPPTTTTTTTTTMTTTTTTTTTTTMMTTTTTTTTTTTTTTTTTMTTTTTTTTMTTTTTTTTMTTTTTTTTTTTTTTTTTTTTTMTTTTTTTTTTTTTPPP
PPPTTTTTTTTTMTTTTTTTTTTTTMTTTTTTTTTTTTTTTTTDTTTTTTTTDTTTTTTTTMTTTTTTTTTTTTTTTTTTTTTMTTTTTTTTTTTTTPPP
PPPTTTTTTTTTDTTTTTTTTTTTTMTTTTTTTTTTTTTTTTTMTTTTTTTTMTTTTTTTTMTTTTTTTTTTTTTTTTTTTTTMTTTTTTTTTTTTTPPP
PPPTTTTTTTTTMTTTTTTTTTTTTMTTTTTTTTTTTTTTTTTMTTTTTTTTMTTTTTTTTMTTTTTTTTTTTTTTTTTTTTTMTTTTTTTTTTTTTPPP
PPPTTTTTTTTTMTTTTTTTTTTTTMTTTTTTTTTTTTTTTTTMTTTTTTTTMTTTTTTTTMMMMMMMMMMMMMMMMMMMMMDMTTTTTTTTTTTTTPPP
PPPTTTTTTTTTMTTTTTTTTTTTTMTTTTTTTTTTTTTTTTTMTTTTTTTTMTTTTTTTTTTTTTTTTTTTTTTTTTTTTTTMTTTTTTTTTTTTTPPP
PPPTTTTTTTTTMMMMMMMMMMMMMMTTTTTTTTTTTTTTTTTMMMMMMMMMMTTTTTTTTMMMMMMMMMMMMMMMMMMMMMMMTTTTTTTTTTTTTPPP
PPPTTTTTTTTTTTTTTTTTTTTTTTTTTTTTTTTTTTTTTTTTTTTTTTTTTTTTTTTTTTTTTTTTTTTTTTTTTTTTTTTTTTTTTTTTTTTTTPPP
PPPTTTTTTTTTTTTTTTTTTTTTTTTTTTTTTTTTTTTTTTTTTTTTTTTTTTTTTTTTTTTTTTTTTTTTTTTTTTTTTTTTTTTTTTTTTTTTTPPP
PPPTTTTTTTTTTTTTTTTTTTTTTTTTTTTTTTTTTTTTTTTTTTTTTTTTTTTTTTTTTTTTTTTTTTTTTTTTTTTTTTTTTTTTTTTTTTTTTPPP
PPPPPPPPPPPPPPPPPPPPPPPPPPPPPPPPPPPPPPPPPPPPPPPPPPPPPPPPPPPPPTTTPPPPPPPPPPPPPPPPPPPPPPPPPPPPPPPPPPPP
PPPTTTTTTTTTTTTTTTTTTTTTTTTTTTTTTTTTTTTTTTTTTTTTTTTTTTTTTTTTTTTTTTTTTTTTTTTTTTTTTTTTTTTTTTTTTTTTTPPP
PPPTTTTTTTTTMMMMMMMMMMTTTTTTTTTTTTTTTTTTTTTMMMMMMMMMMTTTTTTTTMMMMMMMMMMMMMMMMMMMMMMMTTTTTTTTTTTTTPPP
PPPTTTTTTTTTMTTTTTTTTMTTTTTTTTTTTTTTTTTTTTTMTTTTTTTTMTTTTTTTTMTTTTTTTTTTTTTTTTTTTTTTTTTTTTTTTTTTTPPP
PPPTTTTTTTTTMTTTTTTTTMTTTTTTTTTTTTTTTTTTTTTMTTTTTTTTMTTTTTTTTMMDMMMMMMMMMMMMMMMMMMMMTTTTTTTTTTTTTPPP
PPPTTTTTTTTTMTTTTTTTTMMMTTTTTTTTTTTTTTTTTTTMTTTTTTTTMTTTTTTTTMTTTTTTTTTTTTTTTTTTTTTMTTTTTTTTTTTTTPPP
PPPTTTTTTTKTMTTTTTTTTTTMMTTTTTTTTTTTTTTTTTTMTTTTTTTTMTTTTTTTTMTTTTTTTTTTTTTTTTTTTTTMTTTTTTTTTTTTTPPP
PPPTTTTTTTTTMTTTTTTTTTTTMMTTTTTTTTTTTTTTTTTMTTTTTTTTMTTTTTTTTMTTTTTTTTTTTTTTTTTTTTTMTTTTTTTTTTTTTPPP
PPPTTTTTTTTTMTTTTTTTTTTTTMTTTTTTTTTTTTTTTTTDTTTTTTTTDTTTTTTTTMTTTTTTTTTTTTTTTTTTTTTMTTTTTTTTTTTTTPPP
PPPTTTTTTTTTDTTTTTTTTTTTTMTTTTTTTTTTTTTTTTTMTTTTTTTTMTTTTTTTTMTTTTTTTTTTTTTTTTTTTTTMTTTTTTTTTTTTTPPP
PPPTTTTTTTTTMTTTTTTTTTTTTMTTTTTTTTTTTTTTTTTMTTTTTTTTMTTTTTTTTMTTTTTTTTTTTTTTTTTTTTTMTTTTTTTTTTTTTPPP
PPPTTTTTTTTTMTTTTTTTTTTTTMTTTTTTTTTTTTTTTTTMTTTTTTTTMTTTTTTTTMMMMMMMMMMMMMMMMMMMMMDMTTTTTTTTTTTTTPPP
PPPTTTTTTTTTMTTTTTTTTTTTTMTTTTTTTTTTTTTTTTTMTTTTTTTTMTTTTTTTTTTTTTTTTTTTTTTTTTTTTTTMTTTTTTTTTTTTTPPP
PPPTTTTTTTTTMMMMMMMMMMMMMMTTTTTTTTTTTTTTTTTMMMMMMMMMMTTTTTTTTMMMMMMMMMMMMMMMMMMMMMMMTTTTTTTTTTTTTPPP
PPPTTTTTTTTTTTTTTTTTTTTTTTTTTTTTTTTTTTTTTTTTTTTTTTTTTTTTTTTTTTTTTTTTTTTTTTTTTTTTTTTTTTTTTTTTTTTTTPPP
PPPPPPPPPPPPPPPPPPPPPPPPPPPPPPPPPPPPPPPPPPPPPPPPPPPPPPPPPPPPPTTTPPPPPPPPPPPPPPPPPPPPPPPPPPPPPPPPPPPP
PPPTTTTTTTTTTTTTTTTTTTTTTTTTTTTTTTTTTTTTTTTTTTTTTTTTTTTTTTTTTTTTTTTTTTTTTTTTTTTTTTTTTTTTTTTTTTTTTPPP
PPPTTTTTTTTTMMMMMMMMMMTTTTTTTTTTTTTTTTTTTTTMMMMMMMMMMTTTTTTTTMMMMMMMMMMMMMMMMMMMMMMMTTTTTTTTTTTTTPPP
PPPTTTTTTTTTMTTTTTTTTMTTTTTTTTTTTTTTTTTTTTTMTTTTTTTTMTTTTTTTTMTTTTTTTTTTTTTTTTTTTTTTTTTTTTTTTTTTTPPP
PPPTTTTTTTTTMTTTTTTTTMTTTTTTTTTTTTTTTTTTTTTMTTTTTTTTMTTTTTTTTMMDMMMMMMMMMMMMMMMMMMMMTTTTTTTTTTTTTPPP
PPPTTTTTTTTTMTTTTTTTTMMMTTTTTTTTTTTTTTTTTTTMTTTTTTTTMTTTTTTTTMTTTTTTTTTTTTTTTTTTTTTMTTTTTTTTTTTTTPPP
PPPTTTTTTTKTMTTTTTTTTTTMMTTTTTTTTTTTTTTTTTTMTTTTTTTTMTTTTTTTTMTTTTTTTTTTTTTTTTTTTTTMTTTTTTTTTTTTTPPP
PPPTTTTTTTTTMTTTTTTTTTTTMMTTTTTTTTTTTTTTTTTMTTTTTTTTMTTTTTTTTMTTTTTTTTTTTTTTTTTTTTTMTTTTTTTTTTTTTPPP
PPPTTTTTTTTTMTTTTTTTTTTTTMTTTTTTTTTTTTTTTTTDTTTTTTTTDTTTTTTTTMTTTTTTTTTTTTTTTTTTTTTMTTTTTTTTTTTTTPPP
PPPTTTTTTTTTDTTTTTTTTTTTTMTTTTTTTTTTTTTTTTTMTTTTTTTTMTTTTTTTTMTTTTTTTTTTTTTTTTTTTTTMTTTTTTTTTTTTTPPP
PPPTTTTTTTTTMTTTTTTTTTTTTMTTTTTTTTTTTTTTTTTMTTTTTTTTMTTTTTTTTMTTTTTTTTTTTTTTTTTTTTTMTTTTTTTTTTTTTPPP
PPPTTTTTTTTTMTTTTTTTTTTTTMTTTTTTTTTTTTTTTTTMTTTTTTTTMTTTTTTTTMMMMMMMMMMMMMMMMMMMMMDMTTTTTTTTTTTTTPPP
PPPTTTTTTTTTMTTTTTTTTTTTTMTTTTTTTTTTTTTTTTTMTTTTTTTTMTTTTTTTTTTTTTTTTTTTTTTTTTTTTTTMTTTTTTTTTTTTTPPP
PPPTTTTTTTTTMMMMMMMMMMMMMMTTTTTTTTTTTTTTTTTMMMMMMMMMMTTTTTTTTMMMMMMMMMMMMMMMMMMMMMMMTTTTTTTTTTTTTPPP
PPPTTTTTTTTTTTTTTTTTTTTTTTTTTTTTTTTTTTTTTTTTTTTTTTTTTTTTTTTTTTTTTTTTTTTTTTTTTTTTTTTTTTTTTTTTTTTTTPPP
PPPPPPPPPPPPPPPPPPPPPPPPPPPPPPPPPPPPPPPPPPPPPPPPPPPPPPPPPPPPPTTTPPPPPPPPPPPPPPPPPPPPPPPPPPPPPPPPPPPP
PPPTTTTTTTTTTTTTTTTTTTTTTTTTTTTTTTTTTTTTTTTTTTTTTTTTTTTTTTTTTTTTTTTTTTTTTTTTTTTTTTTTTTTTTTTTTTTTTPPP
PPPTTTTTTTTTMMMMMMMMMMTTTTTTTTTTTTTTTTTTTTTMMMMMMMMMMTTTTTTTTMMMMMMMMMMMMMMMMMMMMMMMTTTTTTTTTTTTTPPP
PPPTTTTTTTTTMTTTTTTTTMTTTTTTTTTTTTTTTTTTTTTMTTTTTTTTMTTTTTTTTMTTTTTTTTTTTTTTTTTTTTTTTTTTTTTTTTTTTPPP
PPPTTTTTTTTTMTTTTTTTTMTTTTTTTTTTTTTTTTTTTTTMTTTTTTTTMTTTTTTTTMMDMMMMMMMMMMMMMMMMMMMMTTTTTTTTTTTTTPPP
PPPTTTTTTTTTMTTTTTTTTMMMTTTTTTTTTTTTTTTTTTTMTTTTTTTTMTTTTTTTTMTTTTTTTTTTTTTTTTTTTTTMTTTTTTTTTTTTTPPP
PPPTTTTTTTKTMTTTTTTTTTTMMTTTTTTTTTTTTTTTTTTMTTTTTTTTMTTTTTTTTMTTTTTTTTTTTTTTTTTTTTTMTTTTTTTTTTTTTPPP
PPPTTTTTTTTTMTTTTTTTTTTTMMTTTTTTTTTTTTTTTTTMTTTTTTTTMTTTTTTTTMTTTTTTTTTTTTTTTTTTTTTMTTTTTTTTTTTTTPPP
PPPTTTTTTTTTMTTTTTTTTTTTTMTTTTTTTTTTTTTTTTTDTTTTTTTTDTTTTTTTTMTTTTTTTTTTTTTTTTTTTTTMTTTTTTTTTTTTTPPP
PPPTTTTTTTTTDTTTTTTTTTTTTMTTTTTTTTTTTTTTTTTMTTTTTTTTMTTTTTTTTMTTTTTTTTTTTTTTTTTTTTTMTTTTTTTTTTTTTPPP
PPPTTTTTTTTTMTTTTTTTTTTTTMTTTTTTTTTTTTTTTTTMTTTTTTTTMTTTTTTTTMTTTTTTTTTTTTTTTTTTTTTMTTTTTTTTTTTTTPPP
PPPTTTTTTTTTMTTTTTTTTTTTTMTTTTTTTTTTTTTTTTTMTTTTTTTTMTTTTTTTTMMMMMMMMMMMMMMMMMMMMMDMTTTTTTTTTTTTTPPP
PPPTTTTTTTTTMTTTTTTTTTTTTMTTTTTTTTTTTTTTTTTMTTTTTTTTMTTTTTTTTTTTTTTTTTTTTTTTTTTTTTTMTTTTTTTTTTTTTPPP
PPPTTTTTTTTTMMMMMMMMMMMMMMTTTTTTTTTTTTTTTTTMMMMMMMMMMTTTTTTTTMMMMMMMMMMMMMMMMMMMMMMMTTTTTTTTTTTTTPPP
PPPTTTTTTTTTTTTTTTTTTTTTTTTTTTTTTTTTTTTTTTTTTTTTTTTTTTTTTTTTTTTTTTTTTTTTTTTTTTTTTTTTTTTTTTTTTTTTTPPP
PPPTTTTTTTTTTTTTTTTTTTTTTTTTTTTTTTTTTTTTTTTTTTTTTTTTTTTTTTTTTTTTTTTTTTTTTTTTTTTTTTTTTTTTTTTTTTTTTPPP
PPPTTTTTTTTTTTTTTTTTTTTTTTTTTTTTTTTTTTTTTTTTTTTTTTTTTTTTTTTTTTTTTTTTTTTTTTTTTTTTTTTTTTTTTTTTTTTTTPPP
PPPTTTTTTTTTMMMMMMMMMMTTTTTTTTTTTTTTTTTTTTTMMMMMMMMMMTTTTTTTTMMMMMMMMMMMMMMMMMMMMMMMTTTTTTTTTTTTTPPP
PPPTTTTTTTTTMTTTTTTTTMTTTTTTTTTTTTTTTTTTTTTMTTTTTTTTMTTTTTTTTMTTTTTTTTTTTTTTTTTTTTTTTTTTTTTTTTTTTPPP
PPPTTTTTTTTTMTTTTTTTTMTTTTTTTTTTTTTTTTTTTTTMTTTTTTTTMTTTTTTTTMMDMMMMMMMMMMMMMMMMMMMMTTTTTTTTTTTTTPPP
PPPTTTTTTTTTMTTTTTTTTMMMTTTTTTTTTTTTTTTTTTTMTTTTTTTTMTTTTTTTTMTTTTTTTTTTTTTTTTTTTTTMTTTTTTTTTTTTTPPP
PPPTTTTTTTKTMTTTTTTTTTTMMTTTTTTTTTTTTTTTTTTMTTTTTTTTMTTTTTTTTMTTTTTTTTTTTTTTTTTTTTTMTTTTTTTTTTTTTPPP
PPPTTTTTTTTTMTTTTTTTTTTTMMTTTTTTTTTTTTTTTTTMTTTTTTTTMTTTTTTTTMTTTTTTTTTTTTTTTTTTTTTMTTTTTTTTTTTTTPPP
PPPTTTTTTTTTMTTTTTTTTTTTTMTTTTTTTTTTTTTTTTTDTTTTTTTTDTTTTTTTTMTTTTTTTTTTTTTTTTTTTTTMTTTTTTTTTTTTTPPP
PPPTTTTTTTTTDTTTTTTTTTTTTMTTTTTTTTTTTTTTTTTMTTTTTTTTMTTTTTTTTMTTTTTTTTTTTTTTTTTTTTTMTTTTTTTTTTTTTPPP
PPPTTTTTTTTTMTTTTTTTTTTTTMTTTTTTTTTTTTTTTTTMTTTTTTTTMTTTTTTTTMTTTTTTTTTTTTTTTTTTTTTMTTTTTTTTTTTTTPPP
PPPTTTTTTTTTMTTTTTTTTTTTTMTTTTTTTTTTTTTTTTTMTTTTTTTTMTTTTTTTTMMMMMMMMMMMMMMMMMMMMMDMTTTTTTTTTTTTTPPP
PPPTTTTTTTTTMTTTTTTTTTTTTMTTTTTTTTTTTTTTTTTMTTTTTTTTMTTTTTTTTTTTTTTTTTTTTTTTTTTTTTTMTTTTTTTTTTTTTPPP
PPPTTTTTTTTTMMMMMMMMMMMMMMTTTTTTTTTTTTTTTTTMMMMMMMMMMTTTTTTTTMMMMMMMMMMMMMMMMMMMMMMMTTTTTTTTTTTTTPPP
PPPTTTTTTTTTTTTTTTTTTTTTTTTTTTTTTTTTTTTTTTTTTTTTTTTTTTTTTTTTTTTTTTTTTTTTTTTTTTTTTTTTTTTTTTTTTTTTTPPP
PPPPPPPPPPPPPPPPPPPPPPPPPPPPPPPPPPPPPPPPPPPPPPPPPPPPPPPPPPPPPPPPPPPPPPPPPPPPPPPPPPPPPPPPPPPPPPPPPPPP
PPPPPPPPPPPPPPPPPPPPPPPPPPPPPPPPPPPPPPPPPPPPPPPPPPPPPPPPPPPPPPPPPPPPPPPPPPPPPPPPPPPPPPPPPPPPPPPPPPPP
PPPPPPPPPPPPPPPPPPPPPPPPPPPPPPPPPPPPPPPPPPPPPPPPPPPPPPPPPPPPPPPPPPPPPPPPPPPPPPPPPPPPPPPPPPPPPPPPPPPP
